###M  / #### ### #######    #
#        ######    #########      
###   #########     #        X
 ##   S           ###      ###
#    ####         ###      ###
###      ###         ###     #
 #_#   ###    # **  **###    #
##      ####               ###
###   ### ##         ###    ##
###      ### ###-###   ###


  MISSINH CHARACTERS INVALID MAZE