##############################
#        #                  #
#  ####  #  ###########  #   #
#  #     #            #  #   #
#  #  ##########  #####  #   #
#  #             #      #   #
#  ###########  ##  #######  #
#             #  #           #
#####  ###### #  ##########  #
#   #  #      #  #        #  #
#   #  #  #####  #  ####  #  #
#   #  #      #  #  #  #  #  #
#   #######  ##  ##  #  #  # #
#          #      #     #    #
###  ####  ###### #  #########
#    #  #         #          #
#    #  ###########  #########
# S  #              #        #
#    ################        #
### ################## #######
#        #                  E
#  ####  #  ###########  #   #
#  #     #            #  #   #
#  #  ##########  #####  #   #
#  #             #      #   #
#  ###########  ##  #######  #
#             #  #           #
#####  ###### #  ##########  #
#   #  #      #  #        #  #
#   #  #  #####  #  ####  #  #
#   #  #      #  #  #  #  #  #
#   #######  ##  ##  #  #  # #
#          #      #     #    #
##########   #################
#######       ################
#        #                  #
#  ####  #  ###########  #   #
#  #     #            #  #   #
#  #  ##########  #####  #   #
#  #             #      #   #
#  ###########  ##  #######  #
#             #  #           #
#####  ###### #  ##########  #
#   #  #      #  #        #  #
#   #  #  #####  #  ####  #  #
#   #  #      #  #  #  #  #  #
#   #######  ##  ##  #  #  # #
#          #      #     #    #
###  ####  ###### #  #########
#    #  #         #          #
#    #  ###########  #########
#   #              #        #
#    ################        #
#######################  #####
#        #                  
#  ####  #  ###########  #   #
#  #     #            #  #   #
#  #  ##########  #####  #   #
#  #             #      #   #
#  ###########  ##  #######  #
#             #  #           #
#####  ###### #  ##########  #
#   #  #      #  #        #  #
#   #  #  #####  #  ####  #  #
#   #  #      #  #  #  #  #  #
#   #######  ##  ##  #  #  # #
#          #      #     #    #
#             #  #           #
#####  ###### #  ##########  #
#   #  #      #  #        #  #
#   #  #  #####  #  ####  #  #
#   #  #      #  #  #  #  #  #
#   #######  ##  ##  #  #  # #
#          #      #     #    #
#   #######  ##  ##  #  #  # #
#          #      #     #    #
#             #  #           #
#####  ###### #  ##########  #
#   #  #      #  #        #  #
#   #  #  #####  #  ####  #  #
#   #  #      #  #  #  #  #  #
#   #######  ##  ##  #  #  # #
#          #      #     #    #
#   #######  ##  ##  #  #  # #
#          #      #     #    #
#             #  #           #
#####  ###### #  ##########  #
#   #  #      #  #        #  #
#   #  #  #####  #  ####  #  #
#   #  #      #  #  #  #  #  #
#   #######  ##  ##  #  #  # #
#          #      #     #    #
#   #######  ##  ##  #  #  # #
#          #      #     #    #
#             #  #           #
#####  ###### #  ##########  #
#   #  #      ## #        #  #
#   #  #  #####  #  ####  #  #
#   #  #      #  #  #  #  #  #
#   #######  ##  ##  #  #  # #
#          #      #     #    #
##############################
















































































