#####
#S  #
### #
#  E#
#####
