#####
#  ##
#  S#
#  E#
#   # 
#####