#####
#  ##
# ES#
#   #
#   # 
#####