#####
#  ##
#  E#
#  S#
#   # 
#####