#####
#  ##
# SE#
#   #
#   # 
#####