######
#S   #
# ## #
#  # #
######