######
#    #
# ## #
#  #E#
######
