#########
# S #  ##
#      ##
#  ###  #    
#    ## # 
#   E   #  
#  #  ###
####    #    
#########






