##S##
## ##
#   #
# ###
#   #
#E ##