##S##
#  ##
#   #
#   #
#   # 
#E ##