#####################
#        #          
#  ####  #  ####### # 
#  # S   #          #
#  #   #########   ##
#  #             #  #
#  ###########  ##  #
#             #  # #         
#####  ###### #  ###
#   #  #      #  #  #               
#   #     #####  #  #
#   #  #      #  #  # 
#   #######  ##  ## # 
#          #      # #   
###  ####  ##### # # 
#    #            # #         
#    #  ########### # 
#  #              #        
#    ################        
###  ################
#        #          #     
#  ####  #  #########
#  #     #          #
#  #  ##########  ###
#  #             #  #
#  ###########  ##  #
#             #  #  #
#####  ###### #  ####
###   #      #  #  #
#   #  #  #####  #  #
#   #         #  #  # 
#   #######  ##  ##    
#          #      #    
##########   ########
#######       #######
#        #           
#  ####  #  #########
#  #     #           
#  #  ##########  ###
#  #             #    
#  ##### #####  ##  #
#             #  #      
#####  ###### ## ####
#   #  #      #  #      
#   #  #  #####  #  #
#   #  #      #  #  #  
#   #######  ##  ##   
#          #      #     
###  ####  #####  # #
#    #  #         #          
#    #  ########### #
#   #              #        
##     ###   ########        
### #######   #######
#        #                  
#  ####  #  #########
#  #     #             
#  #  ##########  ###  
#  #             #      
#  ###########  ##  #
#             #  #           
#####  ###### #  ####
#   #  #      #  #       
#   #  #  #####  #  #
#   #  #      #  #  #
#   #######  ##  ##   
#          #      #     
#             #  #        
#####  ###### #  ####
#   #  #      #  #      
#   #  #  #####  #  #  
#   #  #      #  #  #  
#   #######  ##  ## #  
#          #      #     
#   #######  ##  ## #  
#          #      # #  
#             #  #         
#####  ###### #  ####
#   #  #      #  #        
#   #  #  #####  #  #  
#   #  #      #  #  #   
#   #######  ##  ##  
#          #      # # 
#   ######    ##  ##   
#          #      #      
#             #  #          
#####  ###### #  ####
#   #  #      #  #        
#   #  #  #####  #  #  
#   #         #  #  #    
#   #######  ##  ## #
#          #      #   
#   #######  ##  ##    
# #        #      #     
#             #  #          
#####  ###### #  ####
#   #  #      ## #        
#   #  #  #####  #  #  
#   #  #      #  #  #    
#   #######  ##  ## # 
#   E       #  #  
   ##    #         ##
#####################


































































































