#####################
#                   #
#  ####  #  ####### # 
#  # S   #          #
#  #   #########   ##
#  #             #  #
#  ###########  ##  #
#             #  # ##         
#####  ###### #  ####
#        #          #     
##############  # ###
#            #   #  #    
#   ###   ####  #  ##
# E   #         #   # 
#####################













































