####################################################################################################
#        #                   #######################################################################
#  ####  #  ###########  #   #######################################################################
#  #     #            #  #   #######################################################################
#  #  ##########  #####  #   #######################################################################
#  #             #      #   ########################################################################
#  ###########  ##  #######  #######################################################################
#             #  #           #######################################################################
#####  ###### #  ##########  #######################################################################
#   #  #      #  #        #  #######################################################################
#   #  #  #####  #  ####  #  #######################################################################
#   #  #      #  #  #  #  #  #######################################################################
#   #######  ##  ##  #  #  # #######################################################################
#E         #      #     #    #######################################################################
###  ####  ###### #  ###############################################################################  
#    #  #         #          #######################################################################   
#    #  ###########  ###############################################################################
# S  #              #        #######################################################################
#    ################        #######################################################################
##  ################## #############################################################################
#        #                   #######################################################################
#  ####  #  ###########  #   #######################################################################
#  #     #            #  #   #######################################################################
#  #  ##########  #####  #   #######################################################################
#  #             #      #   ########################################################################
#  ###########  ##  #######  #######################################################################
#             #  #           #######################################################################
#####  #####  #  ##########  #######################################################################
#   #  #      #  #        #  #######################################################################
#   #  #  #####  #  ####  #  #######################################################################
#   #  #      #  #  #  #  #  #######################################################################
#   #######  ##  ##  #  #  # #######################################################################
#          #      #     #    #######################################################################
##########   #######################################################################################
#######       ######################################################################################
#        #                  ########################################################################
#  ####  #  ###########  #   #######################################################################
#  #     #            #  #   #######################################################################
#  #  ##########  #####  #   #######################################################################
#  #             #      #    #######################################################################
#  ###########  ##  #######  #######################################################################
#             #  #           #######################################################################
#####  ###### #  ##########  #######################################################################
#   #  #      #  #        #  #######################################################################
#   #  #  #####  #  ####  #  #######################################################################
#   #  #      #  #  #  #  #  #######################################################################
#   #######  ##  ##  #  #  # #######################################################################
#          #      #     #    #######################################################################
###  ####  ###### #  ###############################################################################
#    #  #         #          #######################################################################
#    #  ###########  ###############################################################################
#                  #        ########################################################################
#    ################        #######################################################################
#######################  ###########################################################################
#        #                  ########################################################################
#  ####  #  ###########  #   #######################################################################
#  #     #            #  #   #######################################################################
#  #  ##########  #####  #   #######################################################################
#  #             #      #   ########################################################################
#  ###########  ##  #######  #######################################################################
#             #  #           #######################################################################
#####  ###### #  ##########  #######################################################################
#   #  #      #  #        #  #######################################################################
#   #  #  #####  #  ####  #  #######################################################################
#   #  #      #  #  #  #  #  #######################################################################
#   #######  ##  ##  #  #  # #######################################################################
#          #      #     #    #######################################################################
#             #  #           #######################################################################
#####  ###### #  ##########  #######################################################################
#   #  #      #  #        #  #######################################################################
#   #  #  #####  #  ####  #  #######################################################################
#   #  #      #  #  #  #  #  #######################################################################
#   #######  ##  ##  #  #  # #######################################################################
#          #      #     #    #######################################################################
#   #######  ##  ##  #  #  # #######################################################################
#          #      #     #    #######################################################################
#             #  #           #######################################################################
#####  ###### #  ##########  #######################################################################
#   #  #      #  #        #  #######################################################################
#   #  #  #####  #  ####  #  #######################################################################
#   #  #      #  #  #  #  #  #######################################################################
#   #######  ##  ##  #  #  # #######################################################################
#          #      #     #    #######################################################################
#   #######  ##  ##  #  #  # #######################################################################
#          #      #     #    #######################################################################
#             #  #           #######################################################################
#####  ###### #  ##########  #######################################################################
#   #  #      #  #        #  #######################################################################
#   #  #  #####  #  ####  #  #######################################################################
#   #  #      #  #  #  #  #  #######################################################################
#   #######  ##  ##  #  #  # #######################################################################
#          #      #     #    #######################################################################
#   #######  ##  ##  #  #  # #######################################################################
#          #      #     #    #######################################################################
#             #  #           #######################################################################
#####  ###### #  ##########  #######################################################################
#   #  #      ## #        #  #######################################################################
#   #  #  #####  #  ####  #  #######################################################################
#   #  #      #  #  #  #  #  #######################################################################
####################################################################################################