###############
#   #       # #
### # ##### # #
#   #E    # # #
###     ### # #
# S       #   #
###  ##########
###############
