#####
#  E#
#  ##
#  S#    
##### 







