#####
#E#E#
#  ##
#EE #
#####



