###M  / #### ### #######    ##
#        ######    #########      
###   #########     #        X
 ##   S@@@    @   ###      ###
#    ####         ###      ###
###      ###         ###     #
 #_#   ###    # **  **###    #
##      ####               ###
###   ### ##         ###    ##
###XXXXX    ### ###-###   ###%


  MISSINH CHARACTERS INVALID MAZE