######
#S   #
# ## #
#  # #
#    #
######