#######################
#     S        #      #
#########  #  #########
#  #  #       #    ###########
# # # ## #   # ###############
### # ## #  # #    ###########
### # ## #  ##################
### #    #   # #   ###########
# # #####   # # #  ###########
# #       # # # # ### 
# #  ###### # # # ### 
# #         # # # ### 
# #    ####### ######
#          E #   ####
####################