#####
# S #
#  ##
#  E#    
##### 







