#####################################################################################################
#        #                   ########################################################################
#  ####  #  ###########  #   ########################################################################
#  #     #            #  #   ########################################################################
#  #  ##########  #####  #   ########################################################################
#  #             #      #   #########################################################################
#  ###########  ##  #######  ########################################################################
#             #  #           ########################################################################
#####  ###### #  ##########  ########################################################################
#   #  #      #  #        #  ########################################################################
#   #  #  #####  #  ####  #  ########################################################################
#   #  #      #  #  #  #  #  ########################################################################
#   #######  ##  ##  #  #  # ########################################################################
#E         #      #     #    ########################################################################
###  ####  ###### #  ################################################################################ 
#    #  #         #          ########################################################################  
#    #  ###########  ################################################################################
# S  #              #        ########################################################################
#    ################        ########################################################################
##  ################## ##############################################################################
#        #                   ########################################################################
#  ####  #  ###########  #   ########################################################################
#  #     #            #  #   ########################################################################
#  #  ##########  #####  #   ########################################################################
#  #             #      #   #########################################################################
#  ###########  ##  #######  ########################################################################
#             #  #           ########################################################################
#####  #####  #  ##########  ########################################################################
#   #  #      #  #        #  ########################################################################
#   #  #  #####  #  ####  #  ########################################################################
#   #  #      #  #  #  #  #  ########################################################################
#   #######  ##  ##  #  #  # ########################################################################
#          #      #     #    ########################################################################
##########   ########################################################################################
#######       #######################################################################################
#        #                  #########################################################################
#  ####  #  ###########  #   ########################################################################
#  #     #            #  #   ########################################################################
#  #  ##########  #####  #   ########################################################################
#  #             #      #    ########################################################################
#  ###########  ##  #######  ########################################################################
#             #  #           ########################################################################
#####  ###### #  ##########  ########################################################################
#   #  #      #  #        #  ########################################################################
#   #  #  #####  #  ####  #  ########################################################################
#   #  #      #  #  #  #  #  ########################################################################
#   #######  ##  ##  #  #  # ########################################################################
#          #      #     #    ########################################################################
###  ####  ###### #  ################################################################################
#    #  #         #          ########################################################################
#    #  ###########  ################################################################################
#                  #        #########################################################################
#    ################        ########################################################################
#######################  ############################################################################
#        #                  #########################################################################
#  ####  #  ###########  #   ########################################################################
#  #     #            #  #   ########################################################################
#  #  ##########  #####  #   ########################################################################
#  #             #      #   #########################################################################
#  ###########  ##  #######  ########################################################################
#             #  #           ########################################################################
#####  ###### #  ##########  ########################################################################
#   #  #      #  #        #  ########################################################################
#   #  #  #####  #  ####  #  ########################################################################
#   #  #      #  #  #  #  #  ########################################################################
#   #######  ##  ##  #  #  # ########################################################################
#          #      #     #    ########################################################################
#             #  #           ########################################################################
#####  ###### #  ##########  ########################################################################
#   #  #      #  #        #  ########################################################################
#   #  #  #####  #  ####  #  ########################################################################
#   #  #      #  #  #  #  #  ########################################################################
#   #######  ##  ##  #  #  # ########################################################################
#          #      #     #    ########################################################################
#   #######  ##  ##  #  #  # ########################################################################
#          #      #     #    ########################################################################
#             #  #           ########################################################################
#####  ###### #  ##########  ########################################################################
#   #  #      #  #        #  ########################################################################
#   #  #  #####  #  ####  #  ########################################################################
#   #  #      #  #  #  #  #  ########################################################################
#   #######  ##  ##  #  #  # ########################################################################
#          #      #     #    ########################################################################
#   #######  ##  ##  #  #  # ########################################################################
#          #      #     #    ########################################################################
#             #  #           ########################################################################
#####  ###### #  ##########  ########################################################################
#   #  #      #  #        #  ########################################################################
#   #  #  #####  #  ####  #  ########################################################################
#   #  #      #  #  #  #  #  ########################################################################
#   #######  ##  ##  #  #  # ########################################################################
#          #      #     #    ########################################################################
#   #######  ##  ##  #  #  # ########################################################################
#          #      #     #    ########################################################################
#             #  #           ########################################################################
#####  ###### #  ##########  ########################################################################
#   #  #      ## #        #  ########################################################################
#   #  #  #####  #  ####  #  ########################################################################
#   #  #      #  #  #  #  #  ########################################################################
#####################################################################################################
#####################################################################################################
#####################################################################################################
#####################################################################################################



































































































