########
#S   #####
##   # #
####  ##
# ###  #
# E   ##
############